48,22
GGGGCCGGGGGGYYYCCYYYYYYYYYYYYYYYYCCYYYMMCCMCCMMM
G          GY                                  M
G          GY                                  M
G          GY                                  M
G          GY    YYYYYYYYY    YYYYYYYYM        M
G          GY    Y       Y    Y       M        M
G          GY    Y       Y    Y       M        M
G          GY    Y       Y    Y       M        M
G          GYYYYYYYYYYYYYY    Y       M        M
C                             Y       M        M
C                             Y       M        M
G                             Y       M        M
GGGGGGGGGGGY   YYYYYYYYYY   YYY       MMMM   MMM
BBBBBBBBBBBB   BBBBBBBBRR   RRRRRRRRRRRRRR   RRR
B                  B   R                       R
B                  B   R                       R
B                  B   R                       R
B      S           B   R                       R
B                  B   R                       R
B                  B   R                       R
B                  B   R                       R
BBBCCBBCCBBCCBBBBBBBBBBRRRRRRRRRCCRRCCRRCCRRRRRR