100,75
GGGGGGGGGGGGGGGGGGGGGGGGGGGGGGGGGGGGGGGGGGGGGGGGGGGGGGGGGB
R                                                        B
R                                                        B
R                                                        B
R       S                                                B
R                                                        B
R                                                        B
R                                                        B
R                        MWR                             B
R                        W W                             B
R                        RWM                             B
R                                                        B
R                                                        B
R                                                        B
R                                                        B
R                                                        B
R                                                        B
R                                                        B
R                                                        B
R                                                        B
YYYYYYYYYYYYYYYYYYYYYYYYYYYYYYYYYYYYYYYYYYYYYYYYYYYYYYYYYY